
R 1000 1000
C    0,    198 ,  220  
F     56    ,  255    ,  39 

NO ./textures/mario.png
SO ./textures/wood.png
WE ./textures/42blue.png
EA ./textures/behang.png
S ./textures/marioblock.png

111111111111111
10000000020000111111111111
10002002002000000000000011
10000000000000111111100111
1000200N0002011     1001
100000000000011     1001
111111000000011   1110011
111111111111111   1020011
100000000000001   1001001
100000000000001   1200001
111121111110111   1111111
