R 2000 1000
NO ./textures/white.png
SO ./textures/wood.png
WE ./textures/behang.png
EA ./textures/42white.png
S ./textures/pillar.png
C 150,170,210
F 70,25,10
11111
10001
100011111
100000001
100020001
100000001
100000001
100000001
1000N0001
111111111