R 900 600
NO ./textures/redbrick.png
SO ./textures/mossy.png
WE ./textures/bluestone.png
EA ./textures/wood.png
S ./textures/barrel.png
F 120,120,120
C 170,170,170
111111111111111111111111111111
1000000000000000000000000000W1
101111111111011110111110111111
10001   10000100000010001
10001   11110111100010201
10001      10000100010001
1000111111110111100010001
1000000010000000000000001
1000000000000000000000001
1211110110011111110111111
1111110110011111110111111
1000000000000000000000001
1011111111110111101111101
1000100110000100000010001
1020100000110111100010001
1000100000110111100010001
1111111111111111111111111